1111111111111111111
1E00000000000010001
1100P00000C00000001
1000010000000010001
1000000000000000001
1111111111111111111