1111111111111111111
1CE00000001001C0001
1000P00000000000001
1000010000000010001
100000001C100000001
1111111111111111111