1111111111111111111
1E000000000C0010001
1100P0000C000000001
100000M000000010001
1000000000C00000001
1111111111111111111