1111111111111111111
1E00000000100010001
1100000100100000001
1000010011100010001
1P0000001C000000001
1111111111111111111