1111111111111111111
1E00000000100010001
1100P00000000000001
1000010011000010001
1000000010C00000001
1111111111111111111