1111111111111111111
1E00000000100010001
1100000000000000001
1000010010000010001
1P0000001C000000001
1111111111111111111